When we think about mapping cities, we tend to think about roads and streets and buildings, and the settlement narrative that led to their creation, or you might think about the bold vision of an urban designer, but there's other ways to think about mapping cities and how they got to be made.	Но можно взглянуть иначе на картографирование городов и на то, как они возникли.	DaveTroy_2014U-DaveTroy_2014U.ru
Today, I want to show you a new kind of map.	Сегодня я хочу показать вам новый вид карт.	DaveTroy_2014U-DaveTroy_2014U.ru
This is not a geographic map.	Это не географическая карта.	DaveTroy_2014U-DaveTroy_2014U.ru
	Это карта взаимоотношений между людьми в моём родном городе, в Балтиморе, штат Мэрилэнд.	DaveTroy_2014U-DaveTroy_2014U.ru
This is a map of the relationships between people in my hometown of Baltimore, Maryland, and what you can see here is that each dot represents a person, each line represents a relationship between those people, and each color represents a community within the network.	Вы можете видеть, что каждая точка отображает человека, каждая линия — связь между людьми, а каждый цвет — отдельное сообщество внутри города.	DaveTroy_2014U-DaveTroy_2014U.ru
Now, I'm here on the green side, down on the far right where the geeks are, and TEDx also is down on the far right.	Я сейчас тут, в зелёной области, внизу справа, там же, где гики. И TEDx тоже справа внизу.	DaveTroy_2014U-DaveTroy_2014U.ru
	(Смех) С другой стороны карты — в основном, афроамериканцы и выходцы из Латинской Америки, интересы которых несколько отличаются от интересов гиков.	DaveTroy_2014U-DaveTroy_2014U.ru
(Laughter) Now, on the other side of the network, you tend to have primarily African-American and Latino folks who are really concerned about somewhat different things than the geeks are, but just to give some sense, the green part of the network we call Smalltimore, for those of us that inhabit it, because it seems as though we're living in a very small town.	Чтобы было понятнее, скажу, что зелёную часть карты мы зовём Смоллтимор, потому что она кажется людям, которые там живут, очень маленьким городком. Мы видим тех же людей снова и снова.	DaveTroy_2014U-DaveTroy_2014U.ru
We see the same people over and over again, but that's because we're not really exploring the full depth and breadth of the city.	Но это оттого, что мы не интересуемся тем, что происходит во всём городе.	DaveTroy_2014U-DaveTroy_2014U.ru
On the other end of the network, you have folks who are interested in things like hip-hop music and they even identify with living in the DC/Maryland/Virginia area over, say, the Baltimore city designation proper.	С другого конца карты — люди, увлекающиеся хип-хоп музыкой, и они даже приезжают жить в Мэрилэнд/Виргиния/Округ Колумбия, в общем, говорят, что Балтимор — подходящее для них место.	DaveTroy_2014U-DaveTroy_2014U.ru
But in the middle, you see that there's something that connects the two communities together, and that's sports.	Но посередине карты вы видите то, что объединяет два сообщества.	DaveTroy_2014U-DaveTroy_2014U.ru
	Это спорт. У нас есть Балтимор Ориолс, футбольная команда Балтимор Рэйвенс, Майкл Фелпс — олимпийский чемпион.	DaveTroy_2014U-DaveTroy_2014U.ru
We have the Baltimore Orioles, the Baltimore Ravens football team, Michael Phelps, the Olympian.	Under Armour, может слышали о такой балтиморской компании.	DaveTroy_2014U-DaveTroy_2014U.ru
Under Armour, you may have heard of, is a Baltimore company, and that community of sports acts as the only bridge between these two ends of the network.	И это сообщество спорта — словно единственный мостик между двумя концами города.	DaveTroy_2014U-DaveTroy_2014U.ru
Let's take a look at San Francisco.	Давайте взглянем на Сан-Франциско.	DaveTroy_2014U-DaveTroy_2014U.ru
You see something a little bit different happening in San Francisco.	Ситуация здесь несколько иная.	DaveTroy_2014U-DaveTroy_2014U.ru
	Тут есть сообщество медиа, политики и новостей, которое существует в Балтиморе и других городах.	DaveTroy_2014U-DaveTroy_2014U.ru
On the one hand, you do have the media, politics and news lobe that tends to exist in Baltimore and other cities, but you also have this very predominant group of geeks and techies that are sort of taking over the top half of the network, and there's even a group that's so distinct and clear that we can identify it as Twitter employees, next to the geeks, in between the gamers and the geeks, at the opposite end of the hip-hop spectrum.	Здесь так же есть очень большое сообщество из гиков и компьютерных техников, пожалуй, крупнейшее на карте. Тут даже есть сообщество, столь отчётливое и видное, что мы можем назвать его «Пользователи Твиттера».	DaveTroy_2014U-DaveTroy_2014U.ru
	Оно расположено между геймерами и гиками, с другого конца от сообщества хип-хопа.	DaveTroy_2014U-DaveTroy_2014U.ru
So you can see, though, that the tensions that we've heard about in San Francisco in terms of people being concerned about gentrification and all the new tech companies that are bringing new wealth and settlement into the city are real, and you can actually see that documented here.	Мы видим, что противоречия, которые мы слышали о Сан-Франциско, про трудности приобретения элитного жилья, новые компьютерные компании, создающие новые блага, поселения внутри города, — всё это правда. И всё это задокументировано здесь.	DaveTroy_2014U-DaveTroy_2014U.ru
You can see the LGBT community is not really getting along with the geek community that well, the arts community, the music community.	Вы видите, что сообщество сексуальных меньшинств не очень близко к сообществу гиков.	DaveTroy_2014U-DaveTroy_2014U.ru
And so it leads to things like this.	Далее мы видим сообщества искусства, музыки.	DaveTroy_2014U-DaveTroy_2014U.ru
["Evict Twitter"] Somebody sent me this photo a few weeks ago, and it shows what is happening on the ground in San Francisco, and I think you can actually try to understand that through looking at a map like this.	И это приводит к чему-то вроде этого: [«Выключите Твиттер»] Мне недавно прислали это фото, и это показывает нам, что происходит в Сан-Франциско. И я думаю, вы можете понять это, глядя на карты вроде этой.	DaveTroy_2014U-DaveTroy_2014U.ru
Let's take a look at Rio de Janeiro.	Посмотрим на Рио-де-Жанейро.	DaveTroy_2014U-DaveTroy_2014U.ru
I spent the last few weeks gathering data about Rio, and one of the things that stood out to me about this city is that everything's really kind of mixed up.	Последние пару недель я собирал данные о Рио, и кроме прочего, я отметил, что в этом городе всё смешалось.	DaveTroy_2014U-DaveTroy_2014U.ru
It's a very heterogenous city in a way that Baltimore or San Francisco is not.	Это очень многонациональный город, не то, что Балтимор и Сан-Франциско.	DaveTroy_2014U-DaveTroy_2014U.ru
You still have the lobe of people involved with government, newspapers, politics, columnists.	Здесь тоже есть люди, занимающиеся управлением, журналистикой, политикой.	DaveTroy_2014U-DaveTroy_2014U.ru
TEDxRio is down in the lower right, right next to bloggers and writers.	TEDxRio — внизу справа, правее блогеров и писателей.	DaveTroy_2014U-DaveTroy_2014U.ru
But then you also have this tremendous diversity of people that are interested in different kinds of music.	Но тут ещё есть потрясающее многообразие людей, которым интересны разные виды музыки.	DaveTroy_2014U-DaveTroy_2014U.ru
Even Justin Bieber fans are represented here.	Тут отображены даже фанаты Джастина Бибера.	DaveTroy_2014U-DaveTroy_2014U.ru
	Другие мальчики-певцы, исполнители кантри, евангельская музыка, фанк и рэп, разговорная комедия.	DaveTroy_2014U-DaveTroy_2014U.ru
Other boy bands, country singers, gospel music, funk and rap and stand-up comedy, and there's even a whole section around drugs and jokes.	Тут даже есть сообщество, связанное с наркотиками и шутками.	DaveTroy_2014U-DaveTroy_2014U.ru
How cool is that?	Как вам такое?	DaveTroy_2014U-DaveTroy_2014U.ru
And then the Flamengo football team is also represented here.	И футбольная команда Фламенго здесь тоже отображена.	DaveTroy_2014U-DaveTroy_2014U.ru
	Вы наблюдаете то же распространение спорта, гражданских институтов, искусства, музыки, но они отображены совсем иначе.	DaveTroy_2014U-DaveTroy_2014U.ru
So you have that same kind of spread of sports and civics and the arts and music, but it's represented in a very different way, and I think that maybe fits with our understanding of Rio as being a very multicultural, musically diverse city.	И я думаю, это наверно совпадает с нашим представлением о Рио, как об очень мультикультурном, музыкально разнообразном городе.	DaveTroy_2014U-DaveTroy_2014U.ru
So we have all this data.	Ну что же, у нас есть все эти данные.	DaveTroy_2014U-DaveTroy_2014U.ru
It's an incredibly rich set of data that we have about cities now, maybe even richer than any data set that we've ever had before.	Это очень большой объём информации о городах, возможно, больше, чем когда-либо.	DaveTroy_2014U-DaveTroy_2014U.ru
So what can we do with it?	И что же мы можем с ними сделать?	DaveTroy_2014U-DaveTroy_2014U.ru
Well, I think the first thing that we can try to understand is that segregation is a social construct.	Думаю, во-первых, мы можем постараться осознать, что разделение — социальная модель.	DaveTroy_2014U-DaveTroy_2014U.ru
It's something that we choose to do, and we could choose not to do it, and if you kind of think about it, what we're doing with this data is aiming a space telescope at a city and looking at it as if was a giant high school cafeteria, and seeing how everybody arranged themselves in a seating chart.	Мы сами решаем, надо нам это или нет. Немного подумав об этом, вы поймёте, что наши действия с этими данными — это разглядывание города в телескоп.	DaveTroy_2014U-DaveTroy_2014U.ru
	Мы смотрим на него, как на гигантский школьный кафетерий, где каждый занимает своё место.	DaveTroy_2014U-DaveTroy_2014U.ru
Well maybe it's time to shake up the seating chart a little bit.	Возможно, настало время слегка изменить расположение мест.	DaveTroy_2014U-DaveTroy_2014U.ru
The other thing that we start to realize is that race is a really poor proxy for diversity.	Другая вещь, которую мы начинаем понимать: раса плохо представляет разнообразие.	DaveTroy_2014U-DaveTroy_2014U.ru
We've got people represented from all different types of races across the entire map here -- only looking at race doesn't really contribute to our development of diversity.	Представители самых разных рас отображены здесь по всей карте.	DaveTroy_2014U-DaveTroy_2014U.ru
So if we're trying to use diversity as a way to tackle some of our more intractable problems, we need to start to think about diversity in a new way.	Глядя лишь на расу, мы не способствуем развитию разнообразия.	DaveTroy_2014U-DaveTroy_2014U.ru
	Если мы хотим использовать различия для решения каких-то наших насущных проблем, нам нужно начать думать о них иначе.	DaveTroy_2014U-DaveTroy_2014U.ru
And lastly, we have the ability to create interventions to start to reshape our cities in a new way, and I believe that if we have that capability, we may even bear some responsibility to do so.	И, наконец, мы способны придать новый облик нашим городам. И я считаю, что если мы можем это, то мы даже в какой-то степени обязаны это делать.	DaveTroy_2014U-DaveTroy_2014U.ru
So what is a city?	Так что же такое город?	DaveTroy_2014U-DaveTroy_2014U.ru
I think some might say that it is a geographical area or a collection of streets and buildings, but I believe that a city is the sum of the relationships of the people that live there, and I believe that if we can start to document those relationships in a real way then maybe we have a real shot at creating those kinds of cities that we'd like to have.	Думаю, кто-то скажет, что это географическая территория или совокупность улиц и зданий. Но я считаю, что город — это сумма взаимоотношений между его жителями.	DaveTroy_2014U-DaveTroy_2014U.ru
	И я верю, что если мы действительно можем начать документировать это, то, возможно, у нас есть шанс сделать города такими, какими мы хотим их видеть.	DaveTroy_2014U-DaveTroy_2014U.ru
Thank you.	Спасибо вам.	DaveTroy_2014U-DaveTroy_2014U.ru
(Applause)	(Аплодисменты)	DaveTroy_2014U-DaveTroy_2014U.ru
