When we think about mapping cities, we tend to think about roads and streets and buildings, and the settlement narrative that led to their creation, or you might think about the bold vision of an urban designer, but there's other ways to think about mapping cities and how they got to be made.	Słysząc termin "odwzorowanie miasta", myślimy o ulicach i budynkach, czynnikach wpływających na ich stworzenie albo o śmiałej wizji miejskiego architekta. Ale można zupełnie inaczej myśleć o mapach miast i tym, jak są przygotowywane.	DaveTroy_2014U-DaveTroy_2014U.pl
Today, I want to show you a new kind of map.	Chciałbym pokazać wam nowy rodzaj mapy.	DaveTroy_2014U-DaveTroy_2014U.pl
This is not a geographic map.	To nie jest mapa geograficzna.	DaveTroy_2014U-DaveTroy_2014U.pl
This is a map of the relationships between people in my hometown of Baltimore, Maryland, and what you can see here is that each dot represents a person, each line represents a relationship between those people, and each color represents a community within the network.	To jest mapa związków międzyludzkich w moim mieście, Baltimore w stanie Maryland. Każda kropka reprezentuje pojedynczą osobę, każda linia to związek pomiędzy tymi ludźmi, a każdy kolor przedstawia wspólnotę w ramach tej sieci.	DaveTroy_2014U-DaveTroy_2014U.pl
Now, I'm here on the green side, down on the far right where the geeks are, and TEDx also is down on the far right.	Ja jestem na zielono, po prawej, z innymi okularnikami i TEDx też jest tutaj po prawej.	DaveTroy_2014U-DaveTroy_2014U.pl
(Laughter) Now, on the other side of the network, you tend to have primarily African-American and Latino folks who are really concerned about somewhat different things than the geeks are, but just to give some sense, the green part of the network we call Smalltimore, for those of us that inhabit it, because it seems as though we're living in a very small town.	(Śmiech) Po przeciwnej stronie mapy znajdziemy głownie Afro-Amerykanów oraz Latynosów, interesujących się czymś innym niż okularnicy. Aby pokazać sens mapy, zieloną część mapy nazwiemy Smalltimore, ponieważ dla tych, którzy ją zamieszkują, jest jak wioska.	DaveTroy_2014U-DaveTroy_2014U.pl
We see the same people over and over again, but that's because we're not really exploring the full depth and breadth of the city.	Spotykamy ciągle tych samych ludzi, tak naprawdę nie odkrywamy miasta w całej jego rozciągłości.	DaveTroy_2014U-DaveTroy_2014U.pl
On the other end of the network, you have folks who are interested in things like hip-hop music and they even identify with living in the DC/Maryland/Virginia area over, say, the Baltimore city designation proper.	Po drugiej stronie siatki mamy ludzi interesujących się hip-hopem. Oni identyfikują się bardziej z mieszkańcami Maryland lub Virginii niż z pozostałymi mieszkańcami Baltimore.	DaveTroy_2014U-DaveTroy_2014U.pl
But in the middle, you see that there's something that connects the two communities together, and that's sports.	Pomiędzy nimi znajdziemy jednak coś, co łączy dwie różne społeczności, a jest to sport.	DaveTroy_2014U-DaveTroy_2014U.pl
We have the Baltimore Orioles, the Baltimore Ravens football team, Michael Phelps, the Olympian.	Mamy drużynę piłkarską i baseballową oraz olimpijczyka, Michaela Phelpsa.	DaveTroy_2014U-DaveTroy_2014U.pl
Under Armour, you may have heard of, is a Baltimore company, and that community of sports acts as the only bridge between these two ends of the network.	Firma sportowa Under Armour ma swoją siedzibę w Baltimore. Sport jest jedynym łącznikiem między tymi dwoma społecznościami.	DaveTroy_2014U-DaveTroy_2014U.pl
Let's take a look at San Francisco.	Przyjrzyjmy się San Francisco.	DaveTroy_2014U-DaveTroy_2014U.pl
You see something a little bit different happening in San Francisco.	Można zauważyć, że w San Francisco wygląda to trochę inaczej.	DaveTroy_2014U-DaveTroy_2014U.pl
On the one hand, you do have the media, politics and news lobe that tends to exist in Baltimore and other cities, but you also have this very predominant group of geeks and techies that are sort of taking over the top half of the network, and there's even a group that's so distinct and clear that we can identify it as Twitter employees, next to the geeks, in between the gamers and the geeks, at the opposite end of the hip-hop spectrum.	Mamy tu media, polityków, dziennikarzy, tak jak w Baltimore i innych miastach. Jednak liczebnie wyróżnia się grupa okularników i fanów techniki, stanowiących prawie połowę sieci. Mamy nawet grupę inną od reszty, którą nazwać możemy pracownikami Twittera.	DaveTroy_2014U-DaveTroy_2014U.pl
So you can see, though, that the tensions that we've heard about in San Francisco in terms of people being concerned about gentrification and all the new tech companies that are bringing new wealth and settlement into the city are real, and you can actually see that documented here.	Obok okularników, pomiędzy nimi a graczami na przeciwnym końcu od słuchaczy hip-hopu. Możecie zobaczyć, że napięcia panujące w San Francisco w związku z gentryfikacją i nowymi firmami gwarantującymi bogactwo i przebudowę miasta są prawdziwe, widać je na tej mapie.	DaveTroy_2014U-DaveTroy_2014U.pl
You can see the LGBT community is not really getting along with the geek community that well, the arts community, the music community.	Możecie zauważyć, że społeczność LGBT nie dogaduje się z okularnikami, społecznością artystów i muzyków.	DaveTroy_2014U-DaveTroy_2014U.pl
And so it leads to things like this.	A to prowadzi do czegoś takiego.	DaveTroy_2014U-DaveTroy_2014U.pl
["Evict Twitter"] Somebody sent me this photo a few weeks ago, and it shows what is happening on the ground in San Francisco, and I think you can actually try to understand that through looking at a map like this.	["Eksmitować Twitter"] Dostałem to zdjęcie parę tygodni temu. Obrazujące ono, co dzieje się w San Francisco. Można spróbować to zrozumieć, analizując naszą mapę.	DaveTroy_2014U-DaveTroy_2014U.pl
Let's take a look at Rio de Janeiro.	Spójrzmy na Rio de Janeiro.	DaveTroy_2014U-DaveTroy_2014U.pl
I spent the last few weeks gathering data about Rio, and one of the things that stood out to me about this city is that everything's really kind of mixed up.	Spędziłem kilka tygodni, zbierając dane o tym mieście i szczególnie uderzyło mnie to, że wszystko jest tu pomieszane.	DaveTroy_2014U-DaveTroy_2014U.pl
It's a very heterogenous city in a way that Baltimore or San Francisco is not.	To miasto bardziej różnorodne niż Baltimore czy San Francisco.	DaveTroy_2014U-DaveTroy_2014U.pl
You still have the lobe of people involved with government, newspapers, politics, columnists.	Nadal mamy odłam ludzi zaangażowanych w politykę czy media.	DaveTroy_2014U-DaveTroy_2014U.pl
TEDxRio is down in the lower right, right next to bloggers and writers.	TEDxRio jest na dole po prawej, tuż obok pisarzy i blogerów.	DaveTroy_2014U-DaveTroy_2014U.pl
But then you also have this tremendous diversity of people that are interested in different kinds of music.	Ale widzimy też ogromną różnorodność ludzi wynikającą ze słuchania różnej muzyki.	DaveTroy_2014U-DaveTroy_2014U.pl
Even Justin Bieber fans are represented here.	Są nawet fani Justina Biebera.	DaveTroy_2014U-DaveTroy_2014U.pl
Other boy bands, country singers, gospel music, funk and rap and stand-up comedy, and there's even a whole section around drugs and jokes.	Inne boys bandy, piosenkarze country, muzyka gospel, funk, rap, komicy stand-up, jest nawet sekcja kawałów i narkotyków.	DaveTroy_2014U-DaveTroy_2014U.pl
How cool is that?	Super, co nie?	DaveTroy_2014U-DaveTroy_2014U.pl
And then the Flamengo football team is also represented here.	Swoich przedstawicieli ma nawet drużyna piłkarska Flamengo.	DaveTroy_2014U-DaveTroy_2014U.pl
So you have that same kind of spread of sports and civics and the arts and music, but it's represented in a very different way, and I think that maybe fits with our understanding of Rio as being a very multicultural, musically diverse city.	Więc mamy taką samą mapę sportu, spraw miejskich, sztuki i muzyki ale reprezentowanych całkiem inaczej, w zgodzie z naszym wyobrażeniem Rio jako multikulturowego i muzycznie zróżnicowanego miasta.	DaveTroy_2014U-DaveTroy_2014U.pl
So we have all this data.	Więc mamy te wszystkie dane.	DaveTroy_2014U-DaveTroy_2014U.pl
It's an incredibly rich set of data that we have about cities now, maybe even richer than any data set that we've ever had before.	W dzisiejszych czasach mamy bardo dużo informacji o miastach, pewnie więcej niż w jakimkolwiek zbiorze danych wcześniej.	DaveTroy_2014U-DaveTroy_2014U.pl
So what can we do with it?	Ale co możemy z nimi zrobić?	DaveTroy_2014U-DaveTroy_2014U.pl
Well, I think the first thing that we can try to understand is that segregation is a social construct.	Po pierwsze musimy zrozumieć, że segregacja jest konstruktem społecznym.	DaveTroy_2014U-DaveTroy_2014U.pl
It's something that we choose to do, and we could choose not to do it, and if you kind of think about it, what we're doing with this data is aiming a space telescope at a city and looking at it as if was a giant high school cafeteria, and seeing how everybody arranged themselves in a seating chart.	Jest to coś, co wybieramy, więc możemy wybrać inaczej. Jeśli się nad tym zastanowić, to nasze badanie jest jak patrzenie przez teleskop na ogromną szkolną stołówkę i określanie, kto z kim siedzi.	DaveTroy_2014U-DaveTroy_2014U.pl
Well maybe it's time to shake up the seating chart a little bit.	Może nadszedł czas zburzyć ten ład.	DaveTroy_2014U-DaveTroy_2014U.pl
The other thing that we start to realize is that race is a really poor proxy for diversity.	Zaczynamy rozumieć, że rasa to zły wyznacznik różnorodności.	DaveTroy_2014U-DaveTroy_2014U.pl
We've got people represented from all different types of races across the entire map here -- only looking at race doesn't really contribute to our development of diversity.	Ludzie wszystkich ras są rozrzuceni po całej mapie. Analizowanie grup wyłącznie według ras nie mówi nam nic o różnorodności.	DaveTroy_2014U-DaveTroy_2014U.pl
So if we're trying to use diversity as a way to tackle some of our more intractable problems, we need to start to think about diversity in a new way.	Jeśli chcemy używać różnorodności jako sposobu na rozwiązanie zawiłych problemów, to musimy inaczej ją rozumieć.	DaveTroy_2014U-DaveTroy_2014U.pl
And lastly, we have the ability to create interventions to start to reshape our cities in a new way, and I believe that if we have that capability, we may even bear some responsibility to do so.	Możemy zmienić strukturę naszych miast i wierzę, że skoro mamy takie możliwości, jest to wręcz nasz obowiązek.	DaveTroy_2014U-DaveTroy_2014U.pl
So what is a city?	Czym więc jest miasto?	DaveTroy_2014U-DaveTroy_2014U.pl
I think some might say that it is a geographical area or a collection of streets and buildings, but I believe that a city is the sum of the relationships of the people that live there, and I believe that if we can start to document those relationships in a real way then maybe we have a real shot at creating those kinds of cities that we'd like to have.	Niektórzy stwierdzą, że to obszar geograficzny, zbiór ulic i budynków. Jednak moim zdaniem jest to suma związków pomiędzy jego mieszkańcami. Jeśli zaczniemy je naprawdę rejestrować, to być może uda się stworzyć takie miasta, o jakich marzymy.	DaveTroy_2014U-DaveTroy_2014U.pl
Thank you.	Dziękuję.	DaveTroy_2014U-DaveTroy_2014U.pl
(Applause)	(Brawa)	DaveTroy_2014U-DaveTroy_2014U.pl
